Product Name	Company Name	Price
Women's Surplice Dress (Available in Plus Size)	Amazon Essentials	
Casual Dresses for Women Sleeveless Cotton Summer Beach Dress A Line Spaghetti Strap Sundresses with Pockets		
Women Casual Loose Sundress Sleeveless Split Maxi Long Beach Shirt Dress Travel Vacation 2024 Summer Outfits	ANRABESS	
Womens Sundress Summer Floral Short Sleeve Wrap V Neck A-Line Midi Dress	FENSACE	
Women's Summer Striped Short Sleeve T Shirt Dress Casual Tie Waist with Pockets	MEROKEETY	
Womens Summer Ruffle Sleeve V Neck Midi Dress 2024 Fashion Casual Fit Flowy Tiered Boho Beach Vacation Sundress	ANRABESS	
Women Summer Casual Short Sleeve Crewneck Aline Swing Flowy Tiered Shirt Maxi Beach Long Dress 2024 Trendy Outfits	ANRABESS	
Womens Dresses 2024 Spring Summer Deep V Neck Elegant Bow tie Mini Dress S-XL	Dokotoo	
Womens Summer Casual Sleeveless Square Neck Smocked Ruffle Backless Boho Mini Dress 2024 Trendy Short Sundress	ANRABESS	
Women Summer Dresses Sleeveless Casual Loose Swing Button Down Midi Dress with Pockets	MOLERANI	
Women's Summer Casual Dress Sweet & Cute V-Neck Mini Dress with Pocket Short Sleevele Ruffle Dress	nclook	
Women's Summer Boho Floral Short Sleeve Button Maxi Dress Flowy Casual Beach Long Tshirt Dresses with Pockets	Akivide	
Women's Summer Dresses Square Neck Casual Short Sleeves Crossover Elastic Waist Party Mini Dress	Wimsihal	
Women's Boho Floral Print Short Sleeve T Shirt Dress Summer Casual Loose Swing Tshirt Midi Dresses with Pockets	Akivide	
Women's Casual Sleeveless Bodycon Beach Tank Ruched Mini Dresses	LILLUSORY	
Women's 2024 Summer Floral Boho Dress Square Neck Strapped Swing A Line Beach Long Maxi Dress	GRACE KARIN	
Womens Sleeveless V Neck Dress with Pocket Summer Beach Midi Flared Tank Dress	HUHOT	
Summer Dresses for Women 2024 Sundresses Sleeveless Beach Swimsuit Cover Ups Spring Casual Loose Tank Tshirt Dress	Disamer	
Womens 2024 Summer Floral Mini Dress Boho Flowy Skater Dresses Short Sleeveless Ruffle Spaghetti Strap Dress	Mansy	
Women's Summer Sleeveless Striped Flowy Casual Long Maxi Dress with Pockets	Hount	
Women's Summer Flutter Short Sleeve Midi Dress Casual Crewneck Flowy Tiered Beach Dresses	MEROKEETY	
Women's Casual Dresses Short Sleeve V-Neck Dress with Pockets	Aloodor	
Summer Dresses for Women 2024 Trendy Boho Floral Print Beach Cover Up Casual Spring Sleeveless Sundresses	ETCYY	
Women's 2024 Summer Short Sleeve Casual Midi Dresses V Neck Floral Sundress Faux Wrap Dress with Pockets	Newshows	
Women's Summer Casual Loose Short Sleeve Long T Shirt Dress Split Maxi Beach Sundress Travel Vacation Outfits	ANRABESS	
Women's Summer Casual T-Shirt Vacation Dresses	MOLERANI	
Women's 2024 Bohemian Summer Floral Print One Shoulder Sleeveless Smocked Ruffle Tiered Beach Long Midi Dress	ZESICA	
Womens Casual Summer Crewneck Short Sleeve Ribbed Mini Tshirt Dress, XS-3XL	Acelitt	
Women Summer Casual Midi Dresses Short Sleeve V Neck Drawstring Knee Length T Shirt Dress with Split and Pocket	HUSKARY	
Women 2024 Summer Ruffle Edge Sleeve Dresses Floral Casual Beach Mini Dress with Pocket	Dokotoo	
Women's Summer Sleeveless Striped T Shirt Tank Midi Dress Casual Scoop Neck Bodycon Dresses	MEROKEETY	
Women's 2024 Halter Neck Floral Summer Casual Sundress	OUGES	
Women’s 2024 Summer Short Sleeve Crewneck T Shirt Maxi Dress Tie Waist Casual Slim Fit Slit Long Beach Dresses	ANRABESS	
Women's Summer Casual Square Neck Dress with Pocket Cute Sleeveless High Waist A-line Sundress Dresses 2024	HUHOT	
Women Summer Dresses Sleeveless Casual Loose Swing Button Down Midi Dress with Pockets	WNEEDU	
Women's Short Sleeve Button Down Flowy Tiered Babydoll Denim Dress	LookbookStore	
Women's Summer Dresses 2024 Halter Neck Sleeveless Smocked Backless Cut Out Floral Flowy A Line Maxi Dress	GRACE KARIN	
Womens 2024 Summer V-Neck Drawstring Ruffle Cap Short Sleeve Side Pockets Mini Dress Sundress	Dokotoo	
Summer Sleeveless Dresses with Pockets Beach Sundress Casual Tshirt Swing Dress	Moskill	
Women Summer Casual Loose Sleeveless Sundress Spaghetti Strap Flowy Boho Linen Beach Vacation Maxi Long Dress 2024	ANRABESS	
Women's 2024 Summer Casual Flutter Short Sleeve Crew Neck Smocked Elastic Waist Tiered Midi Dress	ZESICA	
Women 2024 Summer Sleeveless Tank Dresses Crew Neck Slim Fit Short Casual Ruched Bodycon Party Club Mini Dress	BTFBM	
Women Summer Casual Sleeveless Crewneck Sundress Aline Flowy Tiered Maxi Long Beach Dress Vacation Outfits	ANRABESS	
Women's Summer Spaghetti Strap Casual Swing Tank Beach Cover Up Dress with Pockets	MISFAY	
Womens 2024 Summer Short Dress V Neck Short Sleeve A Line Hollow Out Lace Ruffle Cute Casual Beach Party Dresses	PRETTYGARDEN	
Womens Summer Dresses Beach Casual Loose Tshirt Floral Short Sleeve Flowy Pockets Sundresses	elescat	
Women 2024 Casual Maxi Dress Short Sleeve V Neck Stripe Sundress Split Loose Long Summer Beach T Shirt Dresses	MARZXIN	
Womens Summer Dresses 2024 Sleeveless Button Down Smocked Elastic Waist Ruffle Tiered Casual Swing Mini Dress	Dokotoo	
Women’s 2024 Summer Casual Maxi Dress Flutter Sleeve Scoop Neck Smocked Tiered A Line Flowy Beach Long Sun Dresses	ANRABESS	
Womens 2024 Summer Sleeveless Spaghetti Strap Long Floral Maxi Dress Boho A Line Beach Sundresses	PRETTYGARDEN	
Women's 2024 Summer Swing Mini Dress Casual Spaghetti Straps Sleeveless Smocked Backless Flowy A Line Sundress	ZESICA	
Women's Casual Short Sleeve Wrap Bodycon Ruched Tie Waist Summer Dress	LILLUSORY	
Women's Floral Wrap V-Neck Midi Dress Short Sleeve Boho Summer Beach Long Dress High Low Hem Smocked Dress Women	PRETTYGARDEN	
Summer Dresses for Women 2024 Short Sleeve V Neck Wrap Dress Casual Midi Sundresses	MSBASIC	
Womens Summer Dress Lantern Sleeve Square Neck Tie Back Flowy A-Line Double Layer Hem Mini Dress	ETCYY NEW	
Women's 2024 Summer Trendy V Neck Ruffle Short Sleeve A Line Tiered Flowy Casual Mini Beach Dress with Pockets	ANRABESS	
Women's 2024 Summer Boho Spaghetti Strap Square Neck Solid Color Ruffle A Line Beach Long Maxi Dress	ZESICA	
Summer Dresses for Women V Neck Cap Sleeve Ruffle Hem Smock Short Dress	SOLY HUX	
Womens Summer Casual Tank Dress Sleeveless V Neck T Shirt Sundress Flowy Tiered Swing Mini Beach Vacation Dresses	ANRABESS	
Women Sleeveless Summer Dress 2024 Crewneck Ribbed Knit Ruffle Swing Button Down Beach Sun Mini Tank Short Dresses	BTFBM	
